%%%%%%%%%%%%%%%%%%
%P  .  .  .  .  .%
%                %
%                %
%                %
%.               %
%                %
%                %
%%%%%%%%%%%%%%%%%%
